id,name,price,original_price,discount,rating_average,review_count,brand,category
277620082,Nồi Cookplus Speed Cook 16cm - Màu vàng (Một tay cầm) - LCA3161Y-1,409000,409000,0,0.0,0,LocknLock,
277448944,Chiếu Ngủ Văn Phòng Cao Cấp Cá Nhân Chiếu Cách Nhiệt Thảm Ngủ Trưa Tấm Lót Đa Năng Du Lịch Dã Ngoại - PaKaSa ( Viền màu ngẫu nhiên),69000,138000,69000,0.0,0,PaKaSa,
276440258,"Bình Gas Bơm Bật Lửa Bluesky 5 Đầu Bơm Dung Tích 150gr/275ml Siêu Tiện Dụng, Bình Bơm Gas Bật Lửa Hàn Quốc",58000,58000,0,4.8,18,AlphaVH,
276238012,"Hộp nhựa đựng đồ, đựng thực phẩm đa năng có nắp gài và quai xách tiện lợi nhựa PP trong suốt thương hiệu VIệt Nhật",59000,99000,40000,5.0,1,Việt Nhật,
276165574,[Combo 10] Móc Dán Tường 3D Hình dễ thương – Chịu Lực Tốt – Siêu Dính,29000,40000,11000,2.0,1,HENRYSA Bạn của mọi nhà,
275598585,"Dưỡng Hoa Tươi Lâu Greenhome, Longlife, Phân Bón Cho Hoa Cắt Cành, Gói 5gr, Lâu Tàn, Nở Bông To, Không Bị Hôi Nước",2750,4900,2150,5.0,2,Greenhome,
275570245,Chảo Inox dập nguyên khối Elmich EL-2431OL,426000,900000,474000,4.7,21,Elmich,
275213424,Bình Xịt Diệt Mối Thái Lan,115000,115000,0,4.7,3,smatayoko,
275189108,Cốc giữ nhiệt inox 304 Elmich EL8345 dung tích 480ML - Hàng Chính Hãng,182000,390000,208000,4.8,13,Elmich,
275058873,Bình giữ nhiệt Metro Cafe Tumbler LocknLock LHC4357 - Dung tích 500ml - Phủ sứ,466000,628000,162000,5.0,37,LocknLock,
274721418,Ô Dù Che Mưa Đi Nắng Tự Động Xếp Gấp Gọn Chống UV Cao Cấp Cho Ô Tô Xe Hơi (phiên bản ĐẶC BIỆT 12 nan chịu lực),129000,139000,10000,4.7,18,EVENDAY,
273672038,Ly nhựa 2 lớp Bubble Tea Cold Cup LocknLock HAP529 - Kèm ống hút - Dung tích 720ml,141000,217000,76000,5.0,5,LocknLock,
273619945,Cốc giữ nhiệt inox 304 Elmich EL8312 dung tích 600ml - Hàng Chính Hãng,216000,499000,283000,4.8,23,Elmich,
271772791,"Hộp Che Ổ Điện Dán Tường Chống Nắng Ngoài Trời, Chống Nước Trong Nhà Tắm",18050,19000,950,3.3,3,NAVIVU,
259514009,"10 Muỗng Đong Định Lượng Greenhome, 2 Đầu, Chia Vạch Sẵn, Tiện Lợi, Đong Phân Bón Dạng Bột, Gia Vị",2780,4000,1220,0.0,0,Greenhome,
197571724,"Khăn Tắm, Khăn Mặt, Combo 2 Khăn Lông Cừu Kích Thước 70cm x 140cm, 35cm x 75cm, Tiêu Chuẩn Hàn Quốc Sêu Mềm Mịn, An Toàn Cho Da - Chính hãng ",69000,138000,69000,5.0,1,PaKaSa,
195469953,Súng Bắn Keo (Cỡ Lớn/Nhỏ) Kèm 10 Keo Nến Silicon,95000,100000,5000,4.7,73,NAVIVU,
176309243,Lô 4 cuộn túi rác tiện dụng Inochi- Soji : 25 Lít (54 x 70cm),54000,71818,17818,5.0,8,Inochi,
169362095,"Bàn Chải Chà Chân , Chà Sàn , Giặt Đồ Có Khay Đựng Xà Phòng Hiện Đại GroFa - Chính Hãng ",39000,39000,0,5.0,1,Gro-Fa,
158639945,"Hộp 20 Viên Pin AA / AAA Maxell Alkaline 1,5V - Hàng chính hãng",130000,130000,0,4.8,73,Maxell,
155286369,Bộ Hộp Cơm Tupperware Crysral Wave Lunch Set Kèm Muỗng Nĩa & Túi Đựng,149000,750000,601000,5.0,3,Tupperware,
149349961,Nhang Xanh Phổ Thông 30cm 500g - Chân mộc,165000,165000,0,5.0,50,Nhang Xanh,
134853381,Bình giữ nhiệt LocknLock Feather Light Ring 460ml,391000,601000,210000,4.8,339,LocknLock,
117058329,Giấy lọc cà phê Hario 100 cái (V60-VCF-01-100W),99000,99000,0,5.0,55,Hario,
94778000,"Ô Dù che nắng, che mưa, có nút bấm 2 chiều, hàng chất lượng, dễ thương, thiết kế sang trọng và bền bỉ, ô dù có lựa chọn màu sắc, ",196000,196000,0,4.7,273,XUDI,
83412126,Bình Giữ Nhiệt Lock&Lock Energetic One-Touch Tumbler LHC3249 - 550ML,333000,560000,227000,4.8,3567,LocknLock,
82875291,"Bộ 2 thùng vải, hộp vải đựng đồ đa năng -Màu Nâu Kem + Tặng kèm dây cột tóc- Hộp vải đựng quần áo 2 size đựng quần áo, đồ lót, giày, văn phòng phẩm, đồ dùng cá nhân rất tiện lợi-Bộ 2 hộp vải đựng đồ vải canvas siêu xinh có nắp đậy, tủ vải đựng đồ hộp cái ",99000,99000,0,4.6,144,SOHOGO,
81895232,"Combo 3 Giỏ treo chậu hoa ban công MONROVIA, giỏ sắt treo chậu hoa ban công, chậu treo ban công, kệ treo ban công, móc treo, khung thép, sơn tĩnh điện chính hãng thương hiệu MONROVIA ",115000,115000,0,4.8,94,Monrovia,
73124602,Bình Giữ Nhiệt Bằng Thép Không Gỉ Lock&Lock Vacuum Bottle LHC6180SLV (800ML),436000,677000,241000,4.7,7092,LocknLock,
72128693,Bình xịt phun sương tưới cây bình áp suất nén khí cao cấp 2 lít,98000,135000,37000,5.0,6,OEM,
71178441,"Áo Mưa Bít Dù Trơn, Áo Mưa Kín Người Vải Dù Siêu Dày 1M4, Chống Thấm Hiệu Quả, Phù Hợp Nam Và Nữ, Có Túi Đựng, Có Lựa Chọn Màu Sắc",115000,115000,0,4.7,243,XUDI,
68521325,Trung Nguyên Legend - Phin nhôm hoa văn Trống Đồng,35000,35000,0,5.0,29,Trung Nguyên,
58357614,"Đèn bắt muỗi, ruồi và các loại côn trùng Con Dơi",379000,379000,0,4.5,1021,CON DƠI,
57806524,"Áo Mưa Bộ Vải Dù Cao Cấp Cho Bé Từ 3 -10 Tuổi, Chống Thấm, Che Kín Người An Toàn Cho Bé, Lựa Chọn Màu Sắc Phù Hợp Giới Tính (Giao Màu - Mẫu Ngẫu Nhiên)",110000,110000,0,4.6,108,XUDI,
50701305,Vợt muỗi SUNHOUSE SHE-S800,110000,150000,40000,4.5,36,Sunhouse,
46327991,"Hộp Nhựa Đựng Thực Phẩm Trong Suốt GAGI Mã GH01 Nhựa PP Bền Bỉ, Sử Dụng Cho Cả Lò Vi Sóng Không Bám Mùi Dễ Dàng Vệ Sinh - Hàng Chính Hãng",47000,79000,32000,4.6,184,OEM,
17423771,"5 Viên Pin CR2032 3V Panasonic Lithium thay pin Smartkey , Cmos , Pin thay Airtag - Hàng chính hãng",72000,72000,0,4.1,10,Panasonic,
8282408,Ổ Cắm Điện Huntkey SZM401 Power Strip,109002,109002,0,4.5,2,Huntkey,
6652303,"Mền tuyết NIN HOUSE 100% Microfiber 1m3x2m mới 2024, chăn hè cao cấp mịn màng, chăn lông tuyết nhung nhiều màu",219000,219000,0,4.6,19,Nin House,
892121,Pin Max 8 + 4 Viên Energizer E91 BP8+4 AA,140000,140000,0,5.0,317,Energizer,
277451259,Chai Xịt Đuổi Chuột RAT OFF ANTI RAT SPRAY 200ml Thái Lan,92820,150000,57180,0.0,0,PaKaSa,
276965213,Chảo Inox liền khối Sunhouse Healthy IN20M7E - IN24M7E - IN26M7E - Dùng cho mọi loại bếp,242000,320000,78000,0.0,0,Sunhouse,
276847009,"Vỉ 10 Đôi Đũa Kháng Khuẩn 3 Sọc , Hàng Chuẩn Xuất Nhật , Thiết Kế Chống Trượt Được Sử Dụng Phổ Biến Rộng Rãi Ở Nhà Hàng , Khách Sạn , Trong Gia Đình - Hàng cao cấp",39000,78000,39000,0.0,0,PaKaSa,
276604469,Nhiệt Kế Đo Nhiệt Độ Sữa và Đồ Ăn Cho Bé Nhiệt kế đo thực phẩm,100000,100000,0,0.0,0,LuckyJQR,
276504239,"Đèn Led Trang Trí Tết, Giáng Sinh, Noel Nhiều Kiểu Dáng Dài 10 Mét",123500,130000,6500,1.0,1,NAVIVU,
276452619,Màng co bọc thực phẩm cao cấp - PE Shinsen Inochi - bảo quản thực phẩm tươi sạch nhiều size ( tặng kèm khăn lau đa năng),89000,145000,56000,0.0,0,Inochi,
276451620,"Combo 3 Đèn LED Gắn Tủ , Trang Trí Tủ Phòng Ngủ , Phòng Khách Có Chức Năng Hẹn Giờ - Hàng Chính Hãng",116620,180000,63380,4.5,2,PaKaSa,
276109412,Ổ cắm điện Philips 8 lỗ 2 chấu CHP2180WB/74 (2500W) - 3m,207000,235000,28000,4.5,2,Philips,
275858428,Bộ Hộp Kim Chỉ May Vá Đa Năng 2 Tầng 20 Chi Tiết Tiện Lợi Khâu Vá Quần Áo,69000,95000,26000,4.0,1,PEAFLO,
275405718,Gương Dán Tường Tai Mèo Xoay 14.5 cm PaKaSa - Hàng chính hãng,69000,138000,69000,5.0,1,PaKaSa,
275079966,Đũa - Combo 30 đôi đũa khảm vàng - Đũa ăn viền vàng - đũa ăn cơm - đũa ăn đen viền vàng - Hàng chính hãng,81000,81000,0,0.0,0,Gro-Fa,
274962328,Xô Đựng Nước Gấp Gọn Đa Năng Có Bánh Xe Chậu Gấp Gọn Tiện Lợi Giặt Cây Lau Nhà Chùi Kính Dung Tích 12L,95000,145000,50000,0.0,0,PEAFLO,
274645566,"Hộp đựng thực phẩm Hokori - Hàng nhựa Việt Nhật có khóa thoát khí, có lỗ thoát nước ",75000,120000,45000,5.0,1,Hokori,
274597284,Hộp Nhựa Chia Thuốc 7 Ngăn - Giao Màu Ngẫu Nhiên,19000,38000,19000,4.1,14,PaKaSa,
274580036,"Hộp Đựng Đũa Thìa Dán Tường HOKORI, Bốn Ngăn Tiện Dụng Có Nắp Đậy, Dán Tường Siêu Chắc Chắn - Hàng Việt Nam",189000,378000,189000,5.0,5,Hokori,
274415047,"Đèn pin laser 303 siêu sáng gồm pin, sạc và khóa - Đèn lazer 303 tia Xanh lá - Hàng chính hãng",159000,159000,0,4.8,4,TiMa.lala,
273979410,Tấm Chắn Văng Dầu Mỡ Cho Nhà Bếp - Hàng chính hãng ,29000,58000,29000,5.0,2,PaKaSa,
272400903,Hộp cơm giữ nhiệt inox 304 Elmich EL8303 dung tích 2L - Hàng chính hãng,837000,1699000,862000,5.0,10,Elmich,
271064572,Bình nước Detox Moriitalia 67972002,362000,527000,165000,0.0,0,Moriitalia,
249694552,"Bình xịt nước tưới cây, tạo mẫu tóc FuNu cao cấp - Hàng chính hãng, giao màu ngẫu nhiên",42750,45000,2250,4.3,6,FuNu,
249153233,Hộp Thủy Tinh Chịu Nhiệt Lock&Lock LCB425,136000,211000,75000,5.0,21,LocknLock,
207005253,Bộ 2 Dây Phơi Quần Áo Thông Minh 5M GroFa Giao màu ngẫu nhiên ,29000,29000,0,0.0,0,Gro-Fa,
201040328,Bình giữ nhiệt LocknLock Riga Tumbler Vietnam Edition LHC4160 897ml,438000,736000,298000,5.0,406,LocknLock,
186288399,Lược Bướm Thép Tập Quay CSGO Dùng Tập Luyện - Mô Hình Butterfly CSGO – Lược Butterfly,59000,59000,0,5.0,13,OEM,
177081696,Cây Sứ Thái Kép Hoa Tím - cây cảnh để trong nhà + tặng phân bón cho cây,65000,110000,45000,4.5,36,OEM,
173085730,"Pin CR2 Lithium 3V Energizer dùng cho máy ảnh , máy đo khoảng cách - hàng chính hãng",105000,105000,0,5.0,3,Energizer,
168247093,Kéo Cắt Đa năng Hàn Quốc P300 HWA SHIN,193000,193000,0,5.0,8,HwaShin,
148810239,"Hộp Cơm Cắm Điện Đời Mới Chính Hãng MINIIN, Hâm Nóng, Giữ Nhiệt, Nấu Chín Cơm Và Thức Ăn, 2 Tầng Nhỏ Gọn, 4 Bát Innox Không Gỉ, Tặng Kèm Bộ Đũa Và Thìa, Đa Chức Năng, Dễ Dàng Vệ Sinh",259000,259000,0,4.5,55,MINIIN,
141971329,"Túi Đựng Hộp Cơm Grepaco Giữ Nhiệt Nóng Lạnh Dạng Đứng Có Ngăn Phụ Đựng Đồ Thức Ăn Văn Phòng, Du Lịch – Vải Bố Canvas, Kích Thước Size Vừa, Kiểu Giỏ Xách Thời Trang Nam Nữ - Tặng Túi Đựng Muỗng Nĩa - Hàng Chính Hãng",69000,69000,0,4.8,91,GREPACO,
134360863,"Vỉ 6 Viên Pin AA , Pin AAA Energizer Max 1,5V Alkaline - Hàng chính hãng",90000,90000,0,4.8,139,Energizer,
120552065,Bình giữ nhiệt inox 304 Elmich EL-8013OL dung tích 480ml,143000,389000,246000,4.8,309,Elmich,
84886093,Vợt muỗi thông minh 3in1 SUNHOUSE SHE-PRO11.W,229000,344000,115000,4.5,188,Sunhouse,
71890908,Bộ lau nhà xoay 360 độ Sunhouse KS-CL330S,297000,406000,109000,4.5,692,Sunhouse,
71342375,"Áo Mưa Bít Trẻ Em Vải Dù Siêu Dày Hàng Việt Nam, Chống Thấm Nước, Phơi Mau Khô Ráo, Che Kín Người An Toàn Cho Bé, Có Lựa Chon Size, Giới Tính Cho Bé ( Giao Màu - Mẫu Ngẫu Nhiên Vì Nhiều Hoạt Tiết)",90000,90000,0,4.5,52,XUDI,
67980198,"Phân bón hữu cơ sinh học KingCrop, dùng trồng rau, cây ăn trái sạch, an toàn",70000,70000,0,5.0,7,KINGCROP,
67937873,Tấm bảo vệ nệm Everon White,370000,370000,0,4.7,121,Everon,
59412424,"Bộ Dụng Cụ Bếp (Đũa, Sạn, Vá) Bằng Gỗ Nhãn Tự Nhiên - VAGOO - Làm Thủ Công Chống Thấm, Chống Ẩm Mốc, An Toàn Sức Khoẻ",169000,169000,0,5.0,28,Vagoo,
54682452,Pin vuông 9V Energizer 522 ALKALINE chính hãng ( Mẫu mới ),75000,75000,0,4.8,75,Energizer,
52301339,"Móc Dán Tường Inox SUS304 treo đồ gia đình phòng ăn, nhà bếp, nhà tắm tiện lợi",42750,45000,2250,4.7,3,OEM,
35912717,Cân Tiểu Ly Điện Tử Platform 1 Kg Cao Cấp ,135000,135000,0,4.3,7,OEM,
277571452,Tranh thế giới,139000,139000,0,5.0,3,PROLEA PL,
277369298,"Đèn Bắt Muỗi Tự Động - Máy Bắt Muỗi Thông Minh, Hút Côn Trùng, Công Nghệ Đèn LED, Kiêm Đèn Ngủ Sạc USB - HÀNG CHÍNH HÃNG MINIIN",129000,129000,0,5.0,1,MINIIN,
276801072,Áo Mưa Royal Helmet - Áo Mưa Cánh Dơi có nón,99000,99000,0,0.0,0,Royal helmet,
276285253,Túi Vải Canvas đặc biệt Đựng Ly Giữ Nhiệt Commuter 1180ml tiện lợi đi học đi làm đi chơi - ELEMENTAL,85000,85000,0,5.0,1,Elemental,
276177979,Túi giữ mát đựng cơm hằng ngày LocknLock,203000,315000,112000,4.5,7,LocknLock,
276025122,Chảo inox nguyên khối Elmich Trimax EL 3846 LOL size 28cm,519000,999000,480000,5.0,2,Elmich,
275936249,"Khăn Tắm Nén Du Lịch Tiện Lợi Dùng 1 Lần 70*100cm, Bao Bì Đỏ - Chính Hãng",19000,29000,10000,5.0,2,lilahome,
275869950,Đèn LED gắn tường cảm biến GT16.PIR 15W,193000,367000,174000,5.0,2,Rạng Đông,
275570183,Bình đựng thức ăn giữ nhiệt inox 304 Elmich EL8336 dung tích 800ml,309000,750000,441000,4.7,12,Elmich,
275511640,Chảo chống dính Elmich EL-4718OL,143000,289000,146000,5.0,23,Elmich,
275261014,"Cây lau nhà tự vắt có thùng 2 ngăn Deli, Bộ chổi lau nhà 360 độ kèm 3 bông lau microfiber siêu sạch",45000,81000,36000,4.5,8,Deli,
275090381,"Gói Xi Măng Dẻo 20g Bịt Lỗ Điều Hoà, Đường Ống Nước, Keo Dán Lỗ Tường Bằng Xi Măng",2500,4000,1500,4.7,3,fofaHome,
274965041,"Máy Bắt Muỗi Thông Minh HIKITECH, Diệt Côn Trùng Đa Năng, Hiệu Quả. Tặng kèm Chổi Vệ Sinh Lồng Đèn",279000,279000,0,5.0,12,HIKITECH,
274798475,"[Loại 1 - có Khay ] Máy bắt muỗi diệt côn trùng thông minh, Đèn bắt muỗi kiêm đèn ngủ có cổng sạc USB  - Hãng miDoctor",102000,102000,0,5.0,1,miDoctor,
274650574,Móc Treo Thau Kiểu Vuông Dán Tường Chắc Chắn,18050,19000,950,4.5,2,NAVIVU,
273661034,Bình giữ nhiệt inox 316 Elmich EL8316 dung tích 460ml - Hàng Chính Hãng,256000,490000,234000,4.6,13,Elmich,
273661002,Bình giữ nhiệt inox 316 Elmich EL8315 dung tích 480ml - Hàng Chính Hãng,198000,470000,272000,4.8,26,Elmich,
273244983,Cốc giữ nhiệt inox 304 Elmich EL8309 dung tích 900ml - Hàng Chính Hãng,299000,559000,260000,4.6,25,Elmich,
272484433,Đồng hồ treo tường kim trôi không ồn minimalist phong cách tối giản trang trí phòng khách Bảo hành 12 tháng Deli,139000,304200,165200,4.8,34,Deli,
270102591,"Nhiệt kế đo độ ẩm, máy đo nhiệt độ phòng cho bé - Nhiệt Ẩm Kế Điện Tử 3 Trong 1 - Thương hiệu RiBi - Hàng Chính Hãng",149000,165000,16000,4.8,33,RIBI,
263239696,Pin kiềm AAA Philips LR03P10TS/97 vỉ 10 viên,86000,109000,23000,5.0,8,Philips,
205291681,"Khăn Tắm 100% Cotton Cao Cấp Homemark - Siêu Mềm Mại, Thấm Hút, Dùng Cho Mặt, Gội Đầu, Gym, Thể Thao",75000,89000,14000,4.5,4,Homemark,
199728521,Bộ lau nhà đa năng Space Saving Sunhouse KS-CL3211P,240000,450000,210000,4.3,100,Sunhouse,
196362415,"Máy cắt cỏ, tỉa cành cầm tay LAPUSEN pin khủng 15000mah, động cơ mạnh 1800w",299000,299000,0,4.0,45,lapusen,
191506484,Đèn Bàn Học LED Đọc Sách Làm Việc Chống Cận Bảo Vệ Mắt - Cảm Ứng 5 Cấp Độ Điều Chỉnh  - Điều Chỉnh Vùng Sáng - Gấp Gọn Tiện Lợi ,480000,550000,70000,4.8,89,TRIỀU CƯƠNG TECH ,
190989483,Bình giữ nhiệt Baby Inox 316 Elmich EL8017 dung tích 300ml,237000,319000,82000,5.0,46,Elmich,
187829576,"VỎ GỐI NẰM,GỐI ÔM COTTON MỀM MỊN. THOÁNG MÁT GIÁ SIÊU RẺ,KÍCH THƯỚC 40X60.50X70.35X105.",34400,40000,5600,4.5,51,RioTex,
151462143,Sáo recorder 6 lỗ cao cấp ,89000,89000,0,4.8,10,Anna Tran,
145762926,"Khăn Tắm 100% Cotton Pakistan Cao Cấp Homemark - Siêu Dày, Mềm Mại, Không Phai Màu, Thấm Hút Tốt",33000,39000,6000,4.7,41,Hanvico,
125739804,"BỘ CÂY LAU NHÀ THÔNG MINH SAGOKER, mã BLNEC",249999,249999,0,4.6,156,SAGOKER,
85029640,"Ổ cắm Điện Quang ĐQ ESK 2WR 23-3U (2 lỗ 3 chấu, 3 USB, dây dài 2m, màu trắng đỏ)",200777,267700,66923,5.0,36,Điện Quang,
75330721,"Then Chốt Cài Cửa, Chốt Khóa Bằng Thép Không Gỉ KUNBE An Toàn Tiện Lợi Nhiều Kích Thước",22900,22900,0,4.6,78,KUNBE,
70820849,Pin CR2032 Energizer 3V vỉ 5 viên,75000,75000,0,5.0,261,Energizer,
57867023,Cây Lau Nhà Xoay 360 Độ Sunhouse Ks-Mo350I,127000,200000,73000,4.6,674,Sunhouse,
56383693,Combo 300 túi lọc rác bồn rửa bát,82000,95000,13000,5.0,15,OEM,
54133235,Pin Sạc AA 2000mAh NH15 Power Plus RP2 Energizer NH15 RP2 (Mẫu mới),179000,179000,0,5.0,50,Energizer,
51373821,Đèn bàn học led cảm ứng chính hãng Rạng Đông Model: RD RL 36 LED,225000,225000,0,5.0,37,Rạng Đông,
31672125,GIẤY THƠM BOUNCE  (160 Tờ x 1 hộp ),205000,205000,0,4.7,131,Bounce,
14639229,Nắp Kính Cường Lực Nồi Và Chảo Fivestar,100000,100000,0,4.6,149,Fivestar,
14526627,Quánh Inox 430 Bếp Từ 3 Đáy Fivestar Nắp Kính - Tặng 5 Muỗng Ăn Inox - Bạc,350000,350000,0,4.6,24,Fivestar,
277740569,Bộ thìa 6 chiếc Elmich EL0004 - Hàng chính hãng,319000,319000,0,5.0,1,Elmich,
277410995,"Đệm ngồi đa năng, lót ghế nệm gối NIN House ngồi bệt kiểu dáng Nhật, tựa lưng văn phòng, chống trĩ giảm đau lưng cao cấp",179000,229000,50000,4.0,1,Nin House,
277378901,Lót ly gỗ khắc logo Durex,100000,100000,0,0.0,0,Durex,
276328451,"Màn dây có cửa Funu, vải mềm mịn, mắt lưới nhỏ, định hình ổn định giúp thông thoáng, chống muỗi an toàn, bảo vệ giấc ngủ - Hàng chính hãng",160000,200000,40000,4.3,19,FuNu,
276296831,COMBO 4 Miếng Lót Chân Bàn Ghế Silicone Bọc Chân Bàn Ghế Vuông & Tròn Tiện Lợi,13000,25000,12000,5.0,3,LKB,
276025118,Chảo inox nguyên khối Elmich Trimax EL 3846SI size 20 cm,348000,650000,302000,5.0,7,Elmich,
276018795,Hộp đựng thực phẩm bằng thép không gỉ LocknLock Color Coated STS Container nhiều dung tích,156000,211000,55000,5.0,14,LocknLock,
275493793,Màng PE Bọc Nội Thất Chống Bụi Chống Nước Khi Thi Công,28500,30000,1500,4.8,13,NAVIVU,
275367488,Bình giữ nhiệt inox 304 Elmich EL8295 dung tích 500ml,206000,390000,184000,4.7,22,Elmich,
275224128,Combo 200 Túi Lọc Rác Bọc Bồn Rửa Chén Tiện Lợi,55000,55000,0,4.8,4,PEAFLO,
274944917,"Thanh treo rèm cửa, treo quần áo bằng inox, không cần khoan tường hay bắt vít, cực kỳ tiện dụng - hàng chính hãng",90000,90000,0,4.8,4,Nhà của Mẹ,
274848186,"Vỏ Áo Bọc Nệm Thun Lạnh Khóa Kéo 2 Đầu, Áo Nệm Topper, Gấp 3 Cariva Đủ Kích Thước",160000,160000,0,0.0,0,Cariva,
274435840,Công tắc điều khiển từ xa HT-6220KG 40A 1000m và 3000m,135000,135000,0,4.8,16,HUNONIC,
274067035,Ổ cắm điện Philips CHP2452WB- 3m,264000,299000,35000,5.0,15,Philips,
273671453,"Bàn chải vệ sinh góc chết (khe nhà tắm, nhà bếp, khe cửa...) Hàng chính hãng",40000,40000,0,5.0,1,Nhà của Mẹ,
272913561,"Gel thông tắc sinh học AIKOMI vệ sinh cống, làm sạch đường ống, chậu rửa bát, nhà vệ sinh",75000,75000,0,4.8,31,Ximo,
247316420,Túi 20 Khăn Giấy Nén Hàn Quốc Cao Cấp Loại Dày 2 Lớp 20*20cm - Hàng Chính Hãng,29000,49000,20000,4.8,9,lilahome,
243047801,Gối tựa lưng văn phòng cao su non A kích thước 34 x 34 cm x 6/10cm,145000,145000,0,4.6,63,A,
207941719,Bộ cây lau nhà Lock&Lock Mini Spin Mop & 4 bông lau sàn ETM498MITS2 - Màu xanh mint,662000,1019000,357000,4.5,130,LocknLock,
202519681,Đồng Hồ Báo Thức Để Bàn Có Đèn Đêm Deli - Thân Nhựa Kim Thiếc Cao Cấp Kiểu Dáng Tinh Tế - Có Nút Bấm Báo Lại Báo Thức,189000,340200,151200,4.7,38,Deli,
195109412,"Bộ nồi Inox dập nguyên khối Elmich Trimax Classic EL-2110OL Size 18, 20, 24, chảo 26cm",1880000,3550000,1670000,4.6,39,Elmich,
194818369,"Hộp Đựng Trang Sức Mini Cho Nữ, Đựng Vòng Cổ Nhẫn Bông Tai Hộp Đựng Đồ Trang Sức Có Khóa Kéo",75800,75800,0,4.5,26,HBH,
191918107,Bình lắc LocknLock Balance Shake It Bottle HAP949 800ml,174000,294000,120000,4.8,103,LocknLock,
190989561,Bình đựng thức ăn giữ nhiệt Inox 316 Elmich EL-8019 dung tích 600ml,291000,419000,128000,5.0,30,Elmich,
185653590,Chăn hè cotton chần bông LIDACO Home nhiều mẫu lựa chọn khổ rộng 2mx2m3,152000,250000,98000,4.7,109,LIDACO,
180378151,Bình giữ nhiệt LocknLock Metro Drive LHC4277S 650ml - Kèm ống hút và cọ rửa,410000,637000,227000,4.7,301,LocknLock,
169978766,"Túi Hút Chân Không Đựng Quần Áo, Chăn Ga Gối, Thú Bông Deli - Loại Dày Cao Cấp, Nhiều Hoạ Tiết, Bảo Vệ Quần Áo, Chăn Ga Khỏi Ẩm, Nấm Mốc, Chống Nước Tuyệt Đối",16000,28800,12800,4.7,251,Deli,
162405563,Cọ Bồn Cầu Toilet Nhà Vệ Sinh Cao Cấp Kèm Giá Cắm Chổi  Silicon - Hàng Loại 1 - Chính Hãng MINIIN,75000,75000,0,4.1,29,MINIIN,
140953145,COMBO11 Tấm lót sàn nhà vệ sinh 3T. Vỉ nhựa lót sàn chống trơn Trải Sàn Nhà Tắm/Vệ Sinh/Nhà Bếp,70000,70000,0,4.5,50,3T,
119030223,"Keo Dán Giày, Gỗ, Nhựa, Sứ Siêu Dính Chống Thấm Đa Năng Deli - 7Ml / 20Ml - 7140 / 7149 ",10000,18000,8000,4.6,303,Deli,
118210422,Kê đũa thìa sứ Long Phương AA6216 dụng cụ bàn ăn cao cấp,17500,17500,0,4.8,11,Long Phương,
106563599,"Bóng đèn Philips LED Bright E27 bảo vệ mắt, ánh sáng vàng, ánh sáng trắng (01 bóng)",70000,70000,0,4.8,154,Philips,
69240971,"Ổ khóa cao cấp Toplex, chống cắt tròn, size 40mm",80000,80000,0,4.5,20,TOPLEX,
68413077,"Đèn đọc sách mini, pin sạc tiện dụng Baseus Comfort Reading Mini Clip Lamp ( Dịu mắt, chân kẹp, 3 mức sáng, 350mAh, 24h sử dụng)hàng nhập khẩu",215000,248000,33000,4.7,192,Baseus,
55465365,Pin Max 8 + 4 Viên Energizer E92 BP8+4 AAA - Hàng Chính Hãng Model 2020,139000,139000,0,5.0,197,Energizer,
55427978,Combo Túi Lọc Rác cho bồn rửa chén bát,69749,69749,0,4.0,4,OEM,
26334551,Mền dù cao cấp  - mỏng nhẹ - thoáng mát - Cho giấc ngủ dễ chịu [chăn ga gối đệm],180000,180000,0,4.6,548,A,
3927949,"Bộ sạc Energizer Charger kèm 4 pin Ener AA 2000mAh, tự ngắt sạc (CHVCM4)",460000,460000,0,4.8,273,Energizer,
892141,Pin Max 8 + 4 Viên Energizer E92 BP8+4 AAA,139000,139000,0,5.0,103,Energizer,
718889,Thùng rác nhựa Fitis Compact PPS1-906 - xám - 10L,250000,250000,0,4.7,91,Fitis,
277821947,"Bộ dao, thìa, dĩa Elmich EL0002/0005  - Hàng chính hãng",249000,249000,0,5.0,1,Elmich,
277306388,"Bộ 4 chân đế chống rung cho máy giặt, tủ lạnh - Chân đỡ đa năng máy giặt, tủ lạnh",38500,38500,0,0.0,0,TIEN ANH HOUSE,
276155089,Đệm Lót Ngồi Ghế Gỗ OFFICE CHILL Nệm Lót Ngồi Ghế Văn Phòng Dưới Sàn Nhà Chất Liệu Cao Su Non,220000,220000,0,4.7,3,Office Chill,
275967918,Rổ Úp Bát Việt Nhật Kèm Khay Hứng Nước 3535 ,109000,135000,26000,4.7,3,Việt Nhật,
275569536,"Bao Ngón Tay Cao Su Tăng Độ Bám, Kháng Khuẩn, Dùng Được Cảm Ứng",21000,21000,0,0.0,0,NAVIVU,
275568737,KitchenAid - Tô gốm có nắp tre màu đen - 15cm (1L),367500,490000,122500,0.0,0,KitchenAid,
275427593,Đồng Hồ Pomodoro Hẹn Giờ 60 Phút Kim Loại Nhiều Kiểu Dáng,114000,120000,6000,5.0,8,NAVIVU,
275263278,"Thuốc diệt chuột, Kẹo diệt chuột tiêu diệt cả đàn chuột hàng Thái Lan",63000,65000,2000,5.0,16,ratoff-ars,
275256191,Hộp cơm giữ nhiệt inox 304 Elmich dung tích 1.6L EL8344 - Hàng Chính Hãng,768000,1590000,822000,5.0,3,Elmich,
275219406,"CỌ TOILET CAO CẤP, CỌ CONG 2 MẶT, CHỔI CỌ BỒN CẦU THƯƠNG HIỆU VIỆT NHẬT - Hàng chính hãng",39000,39000,0,5.0,2,Việt Nhật,
273787401,"Nước tắm tượng phật, lau bàn thờ tinh dầu quế Peace Mass 250ml phong thủy (Thuộc nhóm Sản phẩm Lành tính / Hữu cơ/ Sinh học)",36000,36000,0,0.0,0,PEACE MASS,
273596856,Bình giữ nhiệt inox 316 Elmich EL8311 dung tích 800ml - Hàng Chính Hãng,353000,650000,297000,4.7,20,Elmich,
263239689,Pin kiềm AA Philips LR6P4B/97 vỉ 4 viên,38000,48000,10000,4.8,14,Philips,
262362970,Ca giữ nhiệt Flat Table Mug LocknLock LHC4320 - Dung tích 730ml - Tay cầm thoải mái - Miệng ca rộng - Nắp trong suốt,393000,567000,174000,4.8,165,LocknLock,
217695866,"Bóng đèn LED Bulb MPE LBD E27 - Tiết kiệm điện, Tiêu chuẩn Châu Âu, Thương hiệu Việt Nam - Hàng Chính Hãng",23000,38000,15000,5.0,14,MPE,
199727434,Bộ đầu thay cây lau nhà Sweepy ETM970RF - Màu trắng,61000,88000,27000,5.0,2,Sweepy,
194131937,Kệ Gỗ Trang Trí Treo Tường Không Cần Khoan Kích Thước 30/40/50cm Thương Hiệu SIB Decor KT02,98000,119000,21000,0.0,0,SIB DECOR,
191136118,"Bóng Đèn Led Bulb, Led Edison Đui E27 Các Loại - Hàng Chính Hãng NAVIVU",14250,15000,750,4.7,53,NAVIVU,
189491905,"Nhang Sen Thuần Khiết Liên Tâm 20.5cm 160 cây - Ít khói, dịu nhẹ, 100% Đài sen thiên nhiên",70000,70000,0,4.7,226,Liên Tâm,
189459840,Chiếu điều hòa sợi mây tre đan tổng hợp lót vải không dệt cao cấp hàng xuất khẩu 2 mặt giá rẻ 1m2 1m6 1m8 D Danido,193000,196000,3000,5.0,8,D Danido,
186862075,"Nắp Ngăn Mùi Thoát Sàn ECODEALS - Chặn Mùi Hôi Cống, Chống côn trùng, Chống trào ngược - MẪU MỚI CẢI TIẾN, ĐỦ KÍCH CỠ",23000,23000,0,4.5,69,ECO deals,
184591044,"Đèn Pixar, Đèn Bàn Chống Cận Thị, Đèn Đọc Sách LED, Đèn Làm Việc Bảo Vệ Mắt - Hàng Chính Hãng",249000,249000,0,5.0,24,PEAFLO,
176309303,Bộ 6 hộp thực phẩm chữ nhật Inochi-Hokkaido,135000,339000,204000,5.0,4,Inochi,
176059637,"Hộp Pin AAA 1,5V Panasonic R03NT/2S - Hàng chính hãng",55000,55000,0,5.0,14,Panasonic,
174236741,Găng tay cao su tự nhiên Lock&Lock ETM830 (có móc treo),36000,56000,20000,5.0,150,LocknLock,
152446878,Cây mai xanh thái lan - Cây cảnh sân vườn trồng cổng rào ban công,45000,70000,25000,4.5,22,OEM,
142264591,Combo 10 chiếc Gác đũa Thần Tài bằng ốc biển liền khối nhập khẩu từ New Zealand và Úc (CTH747) Nổi ánh xà cừ rất đẹp - mang lại bữa cơm ngon và tài lộc cho gia chủ ,229000,229000,0,5.0,1,HAHANCO,
126865171,"Vỏ gối ôm lụa cao cấp A 35 x 100 cm - mát mẻ, mềm mịn, không kích ứng da",150000,150000,0,4.8,49,A,
101858930,"Áo Mưa Khoá Kéo, Áo Mưa Măng Tô Vải Dù Cao Cấp, Hàng Việt Nam, Khổ To Rộng, Chống Thấm Hiệu Quả, Phù Hợp Nam Và Nữ, Có Túi Đựng, Có Lựa Chọn Màu Sắc",140000,140000,0,4.7,53,XUDI,
88928025,Ổ Cắm Điện Đa Năng Kèm Cổng USB Có Công Tắc Tải 2500W Nắp Chống Giật Chống Cháy Chất Lượng Cao Deli - Dây 2M/3M/5M - ET401 411,119000,214200,95200,5.0,55,Deli,
73314056,Lọ xay tiêu cầm tay nắp viền inox 304 lọ thủy tinh Hobby Home Decor XT mẫu thon cao và mẫu thấp tùy chọn,69000,69000,0,4.7,208,Hobby Home Decor,
59358608,Combo 2 Ron Thanh Nẹp Xốp Chèn Chắn Cửa Chống Bụi Côn Trùng Dài 95cm Legaxi,40000,40000,0,4.6,179,Legaxi,
57999394,Bộ Ga Gối Cotton Đũi Tici LIDACO Cao Cấp - Xanh Mint,159000,229000,70000,4.7,456,LIDACO,
30008695,Vĩ 5 viên pin Maxell dòng cao cấp CR2032,17900,17900,0,5.0,10,Maxell,
15605817,Bộ Dao Nhà Bếp 5 Món Cookplus Lock&Lock CKK101S5BLK,201000,309000,108000,4.6,567,LocknLock,
7957749,Cuộn cáp cho giàn phơi thông minh (2 sợi x 7m),60000,60000,0,4.8,12,Hòa Phát,
3341035,Thuốc kích thích ra rễ N3M,139000,139000,0,4.5,159,N3M,
2395003,Khăn lau đa năng cao cấp 3M xanh dương 36cm,55000,55000,0,4.7,78,3M,
2119169,Bộ Cây Lau Nhà Lock&Lock Squeeze Flat Mop ETM471,668000,1028000,360000,4.5,1247,LocknLock,
696349,Ổ Cắm Điện 4 Lỗ 3 Chấu 3m Philips SPN1248WB/74 (2500W),241000,259000,18000,0.0,0,Philips,
276616101,Gói 4 Miếng Chữ Nhật Cước cọ rửa Scotch Brite 3M 7447 Mạnh hơn inox (10x15cm) ,9000,9000,0,4.8,42,3M,
276285618,Hộp 6 Lõi lọc BRITA MAXTRA PRO (900L),1189000,2039000,850000,4.8,5,Brita,
276158720,Ga chống thấm họa tiết LIDACO đủ size nệm (màu ngẫu nhiên),59000,90000,31000,0.0,0,LIDACO,
276016000,"Pin sạc 4.2V 18650 đầu lồi,dung lượng 6800mAh dùng cho Sạc Dự Phòng, Đèn Pin, Micro Karaoke, Quạt Mini, Đồ Chơi, Cell Laptop, Đèn Pin, Mic, Đèn Laze và các thiết bị điện tử khác - Hàng chính hãng",38000,45000,7000,4.0,1,VSP,
275219457,"Ghế đẩu gấp gọn Hokori nhựa Việt Nhật - Ghế Đẩu,Ghế Xếp Lùn, Ghế Đẩu Gập Gọn Dễ Dàng Mang Theo Du Lịch - Hàng Việt Nam",49000,98000,49000,4.5,2,Hokori,
275059823,Combo 100 Túi lọc trà/ túi vải không dệt có dây rút size  5 x 7 cm - Hàng chính hãng,29000,29000,0,4.7,3,Gro-Fa,
273901995,"Ổ Cắm Điện Loại Chuyển Đổi Đa Năng - Phích Cắm Tiêu Chuẩn US, EURO, UK, AUST - Có 2 Cổng USB (Dual USB) - Phù Hợp Cho Những Chuyến Công Tác Và Du Lịch Nước Ngoài- Chính Hãng",159460,236000,76540,4.5,11,PaKaSa,
273660990,Bình đựng thức ăn giữ nhiệt inox 304 Elmich EL8310 dung tích 1.2L - Hàng Chính Hãng,500000,850000,350000,4.5,4,Elmich,
273546668,"Nhang cây trầm hương đốt xông nhà tẩy uế HÀ XÁ đồ thờ cúng phong thủy, xua đuổi vận xui, thu hút nguồn năng lượng tích cực, thanh lọc không khí, an toàn cho sức khỏe",99000,198000,99000,5.0,45,Trầm Hương Hà Xá,
272639442,Hộp bảo quản thủy tinh LocknLock BLANC - Hộp vuông,82000,127000,45000,4.6,45,LocknLock,
272484839,"Nhiệt ẩm kế, nhiệt kế phòng Deli đồng hồ xem giờ có báo thức đo nhiệt độ phòng, độ ẩm phòng ngủ cho bé chính xác",149000,268200,119200,4.8,14,Deli,
272047595,Set 10 móc treo quần áo chống trượt xoay 360 đa năng ,85000,105000,20000,5.0,20,PEAFLO,
271123700,Bình giữ nhiệt LocknLock Daily Macaron LHC3292 - Nắp mở một chạm - Dung tích 480ML,321000,540000,219000,5.0,39,LocknLock,
214497531,"Kệ gia vị,kệ nhà bếp HG FURNITURE",149000,149000,0,5.0,11,HG FURNITURE HiG,
199945017,"Bọc Nệm,Aó Nệm Topper 2 Mặt Có Khóa Khéo Vải Cotton Tici Thoáng Mát Kích Thước 1m/1m2/1m4/1m6/1m8 x 2m dày 5-9cm.",155000,250000,95000,4.6,20,RioTex,
195797725,Thớt tre tự nhiên Sunhouse KS-CHB,85000,125000,40000,5.0,47,Sunhouse,
191140221,"Dung Dịch Thủy Canh Greenhome, Lavamix, Phân Bón Cây Thuỷ Sinh, Hoa Sen, An Toàn Cho Cá, Tép Cảnh",29900,50000,20100,4.6,21,Lavamix,
190791221,"Hộp 4 pin sạc AA AAA Beston dung lượng cao, sạc lại nhiều lần - Hàng chính hãng",60000,60000,0,4.8,46,BESTON,
181988661,Bình Bơm ga cho bật-lửa-hộp-quẹt kèm 5 đầu bơm các loại bật-lửa-gas - Blue Hàn Quốc 150 gram,90000,90000,0,4.7,3,OEM,
176309253,Túi rác tiện dụng Inochi -Soji 50L x 19 túi (Size L) Hương Lavender có quai,26000,39000,13000,5.0,4,Inochi,
154157961,"Màn Dây Không Cửa FUNU Chống Muỗi Cao Cấp, Vải Màn Mềm, Mịn, Mắt Dày Dặn Chống Muỗi Tuyệt Đối - Hàng Chính Hãng",137750,145000,7250,4.7,169,FuNu,
152446804,Cây Kim Thanh Mai - cây cảnh bonsai để bàn,39000,58000,19000,4.8,23,OEM,
147265095,"Vỉ 2 Viên Pin Đại ( Pin D ) 1,5V DURACELL Siêu Bền - Hàng chính hãng",155000,155000,0,4.5,15,DURACELL,
143363686,"Băng keo chống thấm x2000 Nhật Bản chống thấm dột, dán tường, dán mái tôn, dán ống nước",152000,160000,8000,4.6,60,OEM,
121396300,"Dây rút nhựa 10cm ,15cm, 20cm, 25cm, 30cm ( Khoảng 80 sợi/bịch )",28000,28000,0,4.8,201,OEM,
118898224,Trung Nguyên Legend - Phin nhôm hoa văn màu đen Vĩ Nhân - có hộp giấy (giao mẫu ngẫu nhiên),79000,79000,0,4.8,111,Trung Nguyên Legend,
114204741,Bình giữ nhiệt inox 304 Sunhouse 450ml KS-TU450I,87000,87000,0,4.6,18,Sunhouse,
108605078,Pin kiềm Akaline AA Deli - Vỉ 2 viên/ 4 viên - 18500 / 18501,20000,36000,16000,4.8,74,Deli,
107336808,Bộ chăn chần ga giường cotton Tici kẻ LIDACO cao cấp (Nhiều mẫu lựa chọn),469000,690000,221000,4.5,133,LIDACO,
85029571,Set 5 Phích cắm công suất lớn Điện Quang ECO ĐQ EPR HP 2PN ECO (Màu ngẫu nhiên),46008,60400,14392,4.8,94,Điện Quang,
79948028,Đèn năng lượng mặt trời mô hình camera chống nước,72000,108000,36000,4.2,13,OEM,
74695680,"Hộp đựng cơm văn phòng, Hộp Cơm Cắm Điện 3 Tầng Inox ,Hộp hâm nóng thức ăn YOICE- HÀNG CHÍNH HÃNG",479000,479000,0,4.8,87,Yoice,
54122078,Pin AAAA Energizer E96 BP2,75000,75000,0,5.0,178,Energizer,
43896673,"Keo chà ron gạch cao cấp, keo dán mạch gạch siêu bám dính chống thấm nước dung tích 280ml - màu trắng",75000,95000,20000,4.3,9,OEM,
36015001,Lõi lọc nước 11 inch loại kết nối chữ I - lõi đúc,145000,160000,15000,4.7,14,YAMATO,
22081865,TÚI ÁO BÌNH GIỮ NHIỆT TIỆN LỢI,38000,40000,2000,4.7,265,OEM,
20680352,Combo 5 bẫy diệt chuột thông minh,85000,85000,0,4.5,53,OEM,
6137123,"Phân Bón Npk 20-20-15 đa năng 3 màu  (1Kg)- bón cây, rau, cây ăn trái, hoa kiểng - bón gốc dễ sử dụng, kích thích ra lá, ra hoa, đậu trái",55000,55000,0,4.6,165,Bình Điền Mekong,
2432307,Decal dán tường đoàn tàu sở thú ZOOYOO AM7123,39000,70000,31000,4.7,33,ZOOYOO,
1657931,Vợt Muỗi Sunhouse SHE-E200 - Vàng,92000,92000,0,4.7,59,Sunhouse,
276409126,Giá Đựng Sách Để Bàn Deli - Kệ Chia 4 Ngăn Văn Phòng Học Sinh Sinh Viên - Chặn Sách Nhiều Ngăn Giúp Sắp Xếp Tài Liệu,69000,124200,55200,0.0,0,Deli,
276379807,"Đèn Học Kẹp Bàn Chống Cận Cho Học Sinh PaKaSa , Đèn Cảm Ứng Kẹp Bàn Xoay 360 Độ - Hàng chính hãng",111860,174000,62140,4.8,4,PaKaSa,
275986366,"Hộp Quẹt Đồng Hồ, Bật Lửa Đồng Hồ tích hợp độc lạ sang trọng, Mạ Vàng 2 in 1 ",130000,130000,0,2.0,1,OEM,
275426511,Nhiệt Kế Đo Nhiệt Độ Sữa và Đồ Ăn Cho Bé - Hàng chính hãng,59000,59000,0,3.8,5,Gro-Fa,
275405659,"Miếng ngăn rác và giữ nước bồn rửa chén, lavabo, bồn rửa mặt PaKaSa (giao màu ngẫu nhiên)",9900,18000,8100,4.0,1,PaKaSa,
275263106,"Ga Chống Thấm Bảo Vệ Đệm, Ga Chống Thấm Tuyệt Đối, Giao Màu Ngẫu Nhiên",77000,77000,0,0.0,0,HT SYS,
275008181,Nhang Không Tăm Trầm Hương Đặc Biệt 3 Lành 20cm 30-150gr Tự Nhiên 100% Ít Khói 7-12 Năm Trầm Thờ Cúng Thư Giãn Xông Nhà Tẩy Uế Yoga Thiền Định,148940,236412,87472,0.0,0,3lành,
274912542,Dây Thun Ràng Buộc Hàng Co Dãn Cao Cấp Chắc Chắn dài 3m Có 2 Móc PaKaSa - Hàng Chính Hãng ,39000,78000,39000,0.0,0,PaKaSa,
274558570,"(Ngang 45-75cm) Tủ Nhựa Gấp Gọn Size Lớn, Tủ Đựng Quần Áo Đa Năng Lắp Ghép, Để Đồ Tiện Dụng, Nhựa PP, Có Bánh Xe",650000,1063000,413000,4.3,3,Nubie,
274067031,Ổ cắm điện Philips CHP1130WB - 3m,93000,105000,12000,5.0,21,Philips,
273554998,Trung Nguyên Legend - Phin nhôm hoa văn Trung Nguyên - Màu nâu,99000,99000,0,5.0,3,Trung Nguyên Legend,
273400802,"Bộ Bình Trà Tử Sa Mini Có Túi Đựng Đi Du Lịch Tiện Lợi Thích Hợp 2 - 4 Người Dùng Gồm 1 Ấm Trà, 4 Tách, 1 Bình Đựng Trà",135000,195000,60000,4.5,7,PEAFLO,
271978704,"Miếng Nam Châm Siêu Hút Dán Tủ Lạnh, Bảng Đen Kèm Keo 2 Mặt",6650,7000,350,4.8,4,NAVIVU,
253176290,Bình pha cà phê Cold Brew Hario 650ml FIC-70,645000,750000,105000,4.8,47,Hario,
252053150,"Đèn Bắt Muỗi Rạng Đông Công Suất 5W Không Mùi, Không Tiếng Ồn",299000,299000,0,3.0,2,Rạng Đông,
215891498,"Keo Acrylic B7000 / T7000 Dán Kính Điện Thoại, Dán Giày, Dán Nhựa, Kim Loại, Gỗ, Đá, Thủy Tinh, Da",27075,28500,1425,4.8,52,NAVIVU,
205920877,"Bộ Nam Châm Dán Cửa Giúp Giữ Cửa Tủ Chắc Chắn, Không Cần Khoan Vít",15000,15000,0,4.6,47,NAVIVU,
199572344,Ghế Gác Chân Văn Phòng Công Thái Học Ergonomic Footrest KUNBE Điều Chỉnh 6 Mức Chiều Cao Massage Chân Bản Cao Cấp,286000,286000,0,4.8,12,KUNBE,
193213443,"Phích Đựng Nước Nóng Rạng Đông, Có Cần Gạt 2,5 lít/ 2 lít/ 1 lít",217400,217400,0,3.0,3,Rạng Đông,
191140204,"Phân bò Lavamix, bao 3dm3, đã qua xử lý, không mùi hôi, hữu cơ tiện lợi ",17900,32220,14320,5.0,7,Lavamix,
186142362,Ô Dù Chống Nắng Che Mưa Cản UV Tự Động Đóng Mở Khung 12 Xương,171000,180000,9000,4.6,118,NAVIVU,
184689674,"Khăn giấy nén rửa mặt dạng viên kẹo hàn quốc, khăn nén ướt dạng viên HBH",1500,1500,0,4.8,13,HBH,
177679445,"Chuông Cửa Không Dây Thông Minh Besti YBT01 (1 Nút Bấm, 1 Chuông ), Chống Nước, Khoảng Cách Sử Dụng Hiệu Quả 300M, 60 Loại Nhạc Chuông, 4 Mức Điều Chỉnh Âm Lượng - Hàng Chính Hãng",200000,200000,0,4.5,36,Besti,
173820044,Trầu Bà Đế Vương Xanh - cây cảnh để bàn + tặng phân bón cho cây,45000,70000,25000,3.9,9,OEM,
164158123,Vỉ 2 Viên Pin Duracell CR2032 / CR2025 / CR2016 Lithium 3V - Hàng chính hãng,79000,79000,0,4.8,56,DURACELL,
130978265,"Ổ cắm Xoay 90° Điện Quang ĐQ ESK RT 6GW (6 lỗ, màu xanh lá trắng)",66971,103300,36329,4.8,81,Điện Quang,
119111659,"Bể bơi cho bé- Bể bơi gia đình - Bể bơi các loại, Bể bơi Phao Cho bé - Bể bơi Bằng Phao Trẻ em Kích Thước Lớn",182000,209000,27000,4.3,7,OEM,
96470903,"Sáp đậu nành (Soy wax) cao cấp dùng làm nến thơm, tealight, tặng mẫu thử tinh dầu Kobi",78000,78000,0,5.0,4,KOBI,
96283992,"Máy Đuổi Chuột bằng Sóng Siêu Âm Mifan - HIệu Quả, An Toàn Không Gây Hại Sức Khoẻ - Bảo hành 3 tháng 1 đổi 1",99000,120000,21000,3.9,97,Mifan,
85908084,Nhang Sạch Phòng Máy Lạnh - Ít khói - Hương trầm dịu nhẹ - Chân tăm mộc - Nhang Xanh - 300g - 20cm,120000,120000,0,4.8,79,Nhang Xanh,
74986804,"Túi đựng hộp cơm cao cấp. Túi giữ nhiệt đa năng nhiều lớp. Túi đựng đồ ăn trưa. Túi chống toả nhiệt, dày dặn, phong cách Hàn Quốc thời trang, hiện đại KORESTAB8001",125000,125000,0,4.8,175,Weyoung,
71924152,"Mùng chụp, màn chụp tự bung chống muỗi FUNU - Hàng chính hãng, sản xuất tại Việt Nam",133000,140000,7000,4.7,243,FuNu,
62469165,Ga Chống Thấm Cotton LIDACO Cao Cấp,139000,250000,111000,4.6,178,LIDACO,
59259444,Mùng chụp tự bung cao cấp FUNU - Màn chống muỗi thông minh - Hàng chính hãng (Sản xuất tại Việt Nam),133000,140000,7000,4.7,430,FuNu,
37929600,Đèn bắt muỗi Đại Sinh D6 tặng kèm 1 bóng thay thế,676200,676200,0,4.7,149,Đại Sinh,
28079716,Hộp đựng xà phòng dầu gội sữa tắm Xinda ZYQ138 White,135000,135000,0,4.8,18,Xinda,
19920919,Bật Lửa Mồi Lửa Bếp Gas Bếp Cồn An Toàn (Màu Sắc Ngẫu Nhiên),29000,29000,0,4.0,1,OEM,
14605513,Nắp Kính Cường Lực Fivestar Nồi Và Chảo,100000,100000,0,4.6,224,Fivestar,
13729970,"Ruột Gối Khách Sạn 5 Sao DADA - Gòn  Microfiber Polyester 
- Êm Ái, Mềm Mại, Dễ Chịu",290000,290000,0,4.6,113,Dada,
2127549,Bình Đựng Dầu Với Nắp Mở Tự Động Lock&Lock CKO101BLK (550ml),166000,258000,92000,4.8,1676,LocknLock,
277263939,"Rèm Cuộn Che Nắng Cách Nhiệt Tự Động Thu Gọn Kèm Móc Hút Dùng Cho Cửa Sổ, Cửa Kính Ôtô - Giao Màu Ngẫu Nhiên",65000,65000,0,5.0,1,TIEN ANH HOUSE,
276652837,"Cây lăn bụi giường 24cm, cây lăn bụi cán dài kèm lõi lăn bụi, hút bụi giường nệm, dính lông mèo, quần áo sàn thảm.",35000,35000,0,5.0,5,KONKA,
276314483,Giá Đỡ Vòi Hoa Sen Dán Tường Đế Góc Nghiêng 120º Móc Treo Vòi Xịt Nhà Tắm Siêu Dính Hamart,49000,90000,41000,4.6,5,GUANG MING,
276274801,"Hộp đựng xà phòng, khay xà phòng tiện lợi phong cách Nhật Bản , Nhựa Việt Nhật - Hàng Việt Nam",29000,58000,29000,5.0,1,Việt Nhật,
275929238,Bình nước thủy tinh Elmich EL-8350T052 dung tích 520ml,264000,310000,46000,4.5,2,Elmich,
275925720,"Chuông Cửa Không Dây Không Dùng Pin, Chống Nước Thông Minh, Chuông Bấm Vĩnh Cửu Báo Động Người Già, 38 Loại Nhạc - Hàng Chính Hãng Besti",180000,180000,0,5.0,1,Besti,
275524596,"Thau, Chậu Nhựa Gấp Gọn Đa Năng Dùng Trong Bệnh Viện , Trường Học , Công Sở - Hàng chính hãng (Giao màu ngẫu nhiên)",59000,59000,0,5.0,1,Gro-Fa,
275496608,"Móc Dán Tường Siêu Dính Chịu Lực Inox 304, Móc Dính Tường Treo Đồ Quần Áo Đồ Dùng Đa Năng Tiện Ích",2000,3000,1000,0.0,0,fofaHome,
275428359,"Bộ Ga Thun Lạnh 4 Món Ga Thun Hàn Quốc Đủ Kích Thước Ga Nệm 1m2, 1m6, 1m8 Chưa Gồm Chăn",178000,220000,42000,3.0,2,KINGROLL MATTRESS R,
275428127,Lọ chiết nước hoa du lịch 5ml GROFA ( Giao màu ngẫu nhiên),29000,29000,0,5.0,2,Gro-Fa,
275422569,"Kệ Sách Gỗ Đẹp Để Bàn FIVO FB26 Cao Cấp Màu Gỗ Và Walnut, Có Hộc, Tiết Kiệm Diện Tích, Bo Góc Thẩm Mĩ",104000,104000,0,4.7,3,FIVO,
275349409,Băng Dán Viền Bếp Bồn Chậu Rửa Trong Suốt Keo Siêu Dính Dán Mép Tường Chống Bẩn Dầu Mỡ Nấm Mốc,33000,65000,32000,5.0,1,Foam Cleaner,
275224132,Bộ 5 Tấm Xốp Dán Tường 3D Giả Gạch Màu 70cmx77cm,65000,65000,0,4.7,3,XỐP 3D KN,
275198071,Ngăn kéo gắn bàn HyperWork Steel Drawer HPW DR-01 - Thép không gỉ - Tải trọng 8kg - Hàng Chính Hãng,429000,429000,0,5.0,1,HyperWork,
274974855,"Lưới Lọc Tóc Dán Nắp Cống, Chặn Côn Trùng, Chống Tắc Nghẽn",16150,17000,850,5.0,3,NAVIVU,
274628787,"Kệ Để Giày Dép Gỗ Thiết Kế Nhỏ Gọn, Tối Ưu Diện Tích Kệ Giày Dép Xếp Gọn Đa Năng Kệ Gỗ MDF Phong Cách Hiện Đại",137000,156000,19000,5.0,2,Gosashi,
274414442,"Găng tay cao su rửa bát, lau dọn, vệ sinh Dài Tay Cổ Chun",29000,29000,0,0.0,0,PEAFLO,
273902288,Cuộn túi hút chân không đựng thực phẩm 1 mặt nhám ( chiều dài mỗi cuộn 500cm) - Henrysa,63800,120000,56200,4.7,9,HENRYSA Bạn của mọi nhà,
273714788,"Thanh Dán Silicon Chặn Nước Tràn Cho Phòng Tắm, Nhà Vệ Sinh",40565,42700,2135,5.0,1,NAVIVU,
270660646,Bình giữ nhiệt Daily Essential LocknLock LHC4325- kèm ống hút và cọ vệ sinh - 870ml -,411000,633000,222000,4.8,17,LocknLock,
247305229,"Cọ Rửa Cán Gỗ Cỡ Lớn Rửa Bình Sữa, Bình Nước, Ly Tách",15000,15000,0,4.8,12,NAVIVU,
206314531,"Đèn Học Để Bàn 2 Thanh 3 Chế Độ Sáng , Ánh Sáng Trắng Hoặc Vàng Tùy Chọn Giúp Bảo Vệ Mắt - Chính hãng  ",161840,240000,78160,5.0,2,PaKaSa,
204986883,"Hộp Đựng Bông Tẩy Trang, Cột Tóc, Tăm Bông Treo Tường Thông Minh - Hàng Loại 1 - Chính Hãng MINIIN",69000,69000,0,3.8,4,MINIIN,
196563202,Bát Ăn Amori Sản Xuất Theo Tiêu Chuẩn Xuất Nhật Chất Liệu Nhựa Nguyên Sinh Đảm Bảo An Toàn Tuyệt Đối Cho Người Sử Dụng- Chính Hãng inochi ( Tặng kèm khăn lau pakasa),25000,38800,13800,4.8,5,Inochi,
195656054,"Hạt Giống Bầu Lai Greenhome, Gói 1gr, Dễ Trồng Quanh Năm, Nảy Mầm Cao, Thu Hoạch Nhanh, Năng Suất Cao T09",9900,16000,6100,5.0,1,Sen Vàng Seeds,
193733810,"[MyJae x Toyal] Giấy Nến 2 Mặt Lót Nồi Chiên, Nướng Bánh, Giấy Lót Chống Dính 30cm x 30cm (50 Tờ/Hộp)",269000,269000,0,5.0,5,MyJae,
190553620,Khăn Vải Đa Năng Tẩy Trang Lau Mặt Dùng Khô/Dùng Ướt,66500,70000,3500,4.8,25,NAVIVU,
189208326,"Thảm nhà tắm, nhà bếp siêu thấm nước, chống trơn trượt tối giản, hiện đại NAVIVU",94050,99000,4950,4.6,89,NAVIVU,
183029245,Mền lông cừu Caro cao cấp A kích thước 1m8 x 2m,195000,195000,0,4.5,59,A,
169650796,"Màn chụp, mùng chụp đỉnh vuông Không chân viền cao cấp Một Cửa - Hàng chính hãng",285000,300000,15000,4.5,66,FuNu,
155253236,HỘP PIN MAXELL 40 VIÊN  AAA TEM BẠC - HÀNG CHÍNH HÃNG,52700,52700,0,5.0,2,Maxell,
102050886,Bàn để ủi quần áo Nakagami tư thế ngồi có giá đỡ chất lượng Công nghệ Nhật Bản - Màu ngẫu nhiên - Hàng chính hãng,155000,155000,0,5.0,39,Nakagami,
75356087,Túi Đựng Hộp Cơm Giữ Nhiệt Đa Lớp Cỡ Lớn 34cm*25cm*15cm,57000,60000,3000,4.7,170,OEM,
75340681,"Hộp Đựng Đồ Đa Năng TD1 – Túi Vải Đựng Quần Áo Chăn Màn Phong Cách Thụy Điển Sang Trọng, Lịch Sự – Hàng Chính Hãng",84000,160000,76000,4.8,736,miDoctor,
69929041,"Móc Treo Quần Áo, Móc Phơi Đồ Trẻ Em Inox Kẹp Chống Rơi, Móc Treo Tất, Vớ, Đồ Lót Nhiều Kiểu Dáng",47500,50000,2500,5.0,235,OEM,
56737206,Túi Rác Tự Hủy Có Quai Tiện Dụng SOJI INOCHI Nhật Bản - Màu Đen Dạng Cuộn - Nhiều Size - Đa dạng công năng sử dụng,19000,20000,1000,5.0,14,Inochi,
50241058,"Kệ sách gỗ để bàn - Tủ,kệ sách mini - Giao màu sắc ngẫu nhiên ",82000,99000,17000,4.5,139,OEM,
46207255,Combo 2 túi lưới giặt đồ 2 lớp Polyester dạng lưới mịn giặt đồ chống biến dạng quần áo cho máy giặt dạng hộp khóa kéo phù hợp giặt đồ nhỏ đồ lót,64600,68000,3400,4.7,116,OEM,
19638219,"Kéo Nhà Bếp Cắt Gà, Mổ Cá Đa Năng Thép Không Gỉ",59000,59000,0,4.7,42,OEM,
6710595,Bộ 10 móc treo dán tường chịu lực 10kg,5835,5894,59,4.3,122,OEM,
277835689,Nồi phủ sứ chống dính Elmich Olive Classic EL- 5535OV - Hàng chính hãng,600000,600000,0,0.0,0,Elmich,
277821906,Hộp cơm 2 tầng inox 304 Elmich EL8381 dung tích 1.3L - Hàng chính hãng,490000,490000,0,5.0,1,Elmich,
276232739,Chai Xịt Bọt Làm Sạch Vệ Sinh Bồn Cầu Toilet Dung Tích 500 Ml Tẩy Rửa Mọi Vết Bẩn Hương Chanh Thơm Mát,29000,32000,3000,0.0,0,fofaHome,
275894840,Vòi Lọc Nước Ra Bát Tăng Áp Xoay 360 Có Thể Kéo Dài Chống Bắn Nước Giao Màu Ngẫu Nhiên,7000,8000,1000,4.5,4,fofaHome,
275869696,Ổ cắm đa năng chống giật OC04 4C/10A,149000,446000,297000,3.0,2,Rạng Đông,
275479540,Kệ kê chậu cây Dài 80-90 cm. Rộng 20-25-30cm. Cao 10-15-20-25-30cm. Hộp thép 2*2cm. 2 nan phụ ( Hàng Chính Hãng ),220000,220000,0,4.0,2,XM,
275073568,"Cây lăn bụi quần áo kiểu mới dành cho nhân viên văn phòng rất tiện lợi,gọn nhẹ dễ sử dụng - Hàng chính hãng ",39000,39000,0,0.0,0,Gro-Fa,
273660960,Dụng cụ đánh trứng tự xoay inox Elmich EL8414 - Hàng Chính Hãng,62200,95000,32800,5.0,6,Elmich,
272318899,Ổ cắm chuyển đổi 3 chấu sang 2 chấu - Hàng chính hãng,23750,25000,1250,4.8,15,FuNu,
263033058,"Chậu tự tưới treo tường Monrovia, treo hoa ban công, trong nhà, sang trọng, tiện lợi, tiêu chuẩn châu Âu",25000,35000,10000,4.7,6,Monrovia,
262512971,Bình ga Blue Hàn Quốc 150 gram cho bật-lửa-hộp-quẹt kèm 5 đầu bơm,90000,90000,0,0.0,0,OEM,
260040913,"Phân Gà Greenhome, Aki Sfarm, Bao 1kg, Nhập Khẩu Nhật, Viên Nén, Hữu Cơ Sinh Học Bón Rau Sạch, Cây Ăn Quả, Hoa Hồng",24900,49800,24900,5.0,7,Đặng Gia Trang,
253390079,Hộp cơm Lock&Lock TOGO bằng nhựa chia ngăn kèm dao muỗng hộp sốt đi kèm HPL817 HPL979,149000,239000,90000,0.0,0,LocknLock,
249829748,Ly Giữ Nhiệt Inox 304 Iced Americano 600ml Kèm Ống Hút,79000,79000,0,4.7,14,PEALO,
197650456,"MÁY RỬA XE NHẬP KHẨU JAPAN 3500W,CÓ CHỈNH ÁP,TẶNG KÈM BÌNH TẠO BỌT",999000,999000,0,4.7,6,Berdywins,
197157654,"Màng Bọc Thực Phẩm , Đồ Ăn PE Shinsen Đạt Tiêu Chuẩn Tiêu Dùng Nhật Bản Đảm Bảo An Toàn Cho Người Sử Dụng - Chính Hãng inochi ( Tặng kèm khăn lau pakasa)",79000,157400,78400,5.0,5,Inochi,
193433927,Đèn Bàn Học Led Đọc Sách Làm Việc Học Tập Bảo Vệ Mắt Chống Cận - 2 Trục Đèn Chiếu Sáng - Gấp Gọn Tiện Lợi ,529000,529000,0,5.0,92,TRIỀU CƯƠNG TECH ,
193223161,Đèn bắt muỗi Rạng Đông DBM01 5W - Chính Hãng,299000,299000,0,5.0,3,Rạng Đông,
191918105,Bộ Bàn Chải Vệ Sinh Các Khe LocknLock ETM415 - 2 cái/bộ,23000,39000,16000,4.8,44,LocknLock,
191918103,Dụng cụ rửa chai và ly LocknLock ETM143DGRY - Màu xám đen,54000,83000,29000,4.8,53,LocknLock,
191140193,"Đất Trồng Cây Greenhome, Bao 6.5dm3 (3kg), Đầy Đủ Dinh Dưỡng, Tiện Lợi, Dễ Sử Dụng, Chuyên Trồng Rau, Hoa, Kiểng",19900,36000,16100,5.0,5,Lavamix,
181223608,Bộ vòi xịt vệ sinh rửa toilet inox 304 tăng áp Hobby home decor VSR1,149000,199000,50000,4.7,64,Hobby Home Decor,
155022095,"Pin SẠC 3V7 18650 hãng DP- Li01 dung lượng 2000mAh dùng cho đèn pin, quạt mini,",28600,28600,0,4.2,5,DP,
152446763,Cây Linh Sam Bonsai - cây cảnh bonsai + tặng phân bón cho cây,55000,110000,55000,4.3,30,OEM,
141349418,Cốc ly sứ có nắp Bát Tràng cao cấp - Cốc sứ uống trà - Cốc sứ uống nước đẹp có nắp giá rẻ,70000,70000,0,5.0,35,Bát Tràng,
138461137,"Combo 12 chiếc Kê đũa, gác đũa – Sự tinh tế trên bàn ăn ",90000,90000,0,5.0,9,Long Phương,
138456818,Màng bọc thực phẩm Laspalm chính hãng MBTP00006163 - 30cmx150m,120000,174900,54900,4.5,2,Las Palms Mission,
109090764,1 Mét Ron Chân Cửa Thanh Chắn Chân Cửa Nhôm Kèm Chổi Sẵn Keo Dán 50mm 60mm Ngăn Bụi Côn Trùng Gián Chuột Legaxi,103000,103000,0,5.0,9,Legaxi,
107793784,Bộ ga giường cotton Tici kẻ LIDACO cao cấp (Nhiều mẫu lựa chọn),156000,249000,93000,4.5,13,LIDACO,
74972494,"Hộp Đựng Thực Phẩm Nhựa Nhật Bản GAGI Mã GH01 Bảo Quản Thực Phẩm Dạng Lỏng Và Khô, Đựng Sữa Cho Bé, Dùng Được Cho Lò Vi Sóng Và Tủ Lạnh - Hàng Chính Hãng",42000,69000,27000,4.7,144,SPEVI,
71206737,Đèn Pin Laser 303 - Hàng Chính Hãng,128250,135000,6750,4.6,271,Essesa,
67425883,Bộ Muỗng Nĩa Trẻ Em ZOKU hình thú 3 món,339150,399000,59850,5.0,3,ZOKU,
57867024,Bộ Lau Nhà Xoay 360 Độ Sunhouse Ks-Cl350PO,310000,310000,0,1.0,1,Sunhouse,
46694285,"NỒI INOX CAO CẤP 3 LỚP ĐÁY LIỀN TRI-MAX 2353731, 2353732, 2353733, 2353734, 2353735, 2353736",800000,999000,199000,4.7,90,Elmich,
45597601,"Ron Dán Che Khe Cửa ,Chân Cửa Chống Gió Lùa , Chống Ồn , Bụi Bẩn, Ngăn Côn Trùng Chính Hãng 3M - Cuộn Dài 5m",89000,89000,0,4.3,335,3M,
32926026,2 Vỉ Pin Panasonic CR2032 ( CR 2032/1PT x 2 Vỉ ) Lithium 3V Chính Hãng,100000,100000,0,4.7,140,Panasonic,
10768545,Ổ Cắm Điện Quang ĐQ 002A-02 (3 Lỗ) dây 2m,85000,85000,0,4.8,6,Điện Quang,
2119173,Cây Lau Nhà Dạng Xịt Nước Lock&Lock ETM472,413000,642000,229000,4.6,1098,LocknLock,
781987,Gối Memory Foam 50D Lock & Lock HLW114 (61 x 34 x 10 cm),541000,833000,292000,4.6,874,LocknLock,
696457,Ổ Cắm Điện 4 Lỗ 3 Chấu 5m Philips SPN1248WC/74 (2500W),326000,369000,43000,4.3,14,Philips,
277740558,"Bình giữ nhiệt inox 304 Elmich EL8378, EL8379",900000,900000,0,0.0,0,Elmich,
277514599,"Thảm Lau Chân 3D Hình Họa Tiết Cute, Chống Trơn Trượt, Siêu Thẩm Nước 40x60cm - HÀNG CHÍNH HÃNG MINIIN",57960,69000,11040,0.0,0,MINIIN,
277438760,Nắp đậy dùng cho lò vi sóng Inomata - Hàng chính hãng,39000,42000,3000,0.0,0,INOMATA,
277436162,( MẪU MỚI ) Quả Lọc Trà Inox SUS 316L Quả Lọc Trà Gia Vị Thảo Quả Lỗ Lọc Siêu Mịn Kháng Khuẩn Công Nghệ CNC Cao Cấp ,65000,65000,0,0.0,0,OEM,
276582990,Dây Rút Tháo Được Có Thể Tái Sử Dụng,33250,35000,1750,0.0,0,NAVIVU,
276137468,"Ổ cắm đơn 2 chấu M3T426US-WE 16A, size S AvatarOn A",28400,28400,0,5.0,1,Schneider Electric,
276042420,"Thùng rác nhựa công cộng SUMIKA B240, dung tích 240L, có bánh xe",650000,650000,0,0.0,0,Sumika,
275627325,[KV] Ly giấy 12oz~354ml - Lốc 50 ly giấy trơn ,35500,35500,0,0.0,0,New Star Paper,
275587830,Bình giữ nhiệt Hydro Flask 21 OZ Standard Flex Straw Cap có nắp xoay - Hàng chính hãng(Season 2024),1350000,1350000,0,0.0,0,Hydro Flask,
275486722,"Máy ép trái cây, ép cam bằng tay (Inox nhỏ)- Hàng nhập khẩu",369000,369000,0,5.0,1,Rainy,
275220519,"Kệ chữ nhật trong HOKORI khung inox 2 / 3 tầng nhựa VIỆT NHẬT cao cấp đựng đồ đa năng - Văn phòng, vệ sinh, phòng khách - Hàng Việt Nam",189000,378000,189000,5.0,3,Việt Nhật,
274841797,"Bàn Học Gấp Gọn Có Khe Để Điện Thoại, Máy Tính Bảng, Khay Để Ly - Hàng Loại 1 (Giao ngẫu nhiên)",129000,165000,36000,4.6,9,PEAFLO,
274319099,Ly Giữ Nhiệt Hình Trụ Thấp Dung Tích 380ml ,72000,85000,13000,5.0,5,PEAFLO,
273396782,Thảm Lau Chân Nhà Tắm Phòng Khách Cao Cấp Chống Trượt Phần Lông Dày Tạo Cảm Giác Mềm Mại Thoải Mái Độ Bền Cao - Giao Màu Ngẫu Nhiên,22000,38000,16000,5.0,2,fofaHome,
273056288,"Bộ Tua Vít Sửa Chữa Đa Chức Năng Deli - 30 Đầu Vít Cao Cấp - Chất Liệu Siêu Bền, Thiết Kế Gọn Nhẹ Tinh Tế",30000,54000,24000,4.7,3,Deli,
263239664,Pin nút Lithium Philips CR2032P5B/97 vỉ 5 viên,88000,100000,12000,4.8,6,Philips,
247655560,Sủi nhựa Vikan 102mm 4061,79000,79000,0,0.0,0,VIKAN,
242497792,"Mặt thiết bị Panasonic dùng cho ổ cắm, công tắc dòng full (mặt 1-2-3-4-6) - Hàng chính hãng",15000,15000,0,0.0,0,Panasonic,
208324553,"Chuông Cửa Không Dây Thông Minh CTFAST CT - 01 (1 Nút Bấm, 1 Chuông ), Chống Nước, Khoảng Cách Sử Dụng Hiệu Quả 300 mét - Hàng Chính Hãng",150000,199000,49000,4.0,4,CTFAST,
197922889,"Cây Kìm Bấm Cúc Vành Áo Kim Loại Đa Năng Bộ Kìm Bấm Khuy Kèm 100 Cúc Bấm 9.5mm Thép Không Gỉ, Khoen Quần Áo Tiện Lợi - hàng Loại 1.  Chính Hãng MINIIN",29000,29000,0,4.1,27,MINIIN,
196568810,"Rèm Dán Cửa Sổ Phòng Ngủ-Trang Trí,Decor-Không Cần Khoan-Nhiều Kích Thước",69000,69000,0,5.0,39,MODERO,
189434234,"Pin AA (2A), AAA (3A) Maxell Alkaline LR3 LR6 Longer Lasting Power siêu bền chính hãng -vỉ 2 viên",14900,14900,0,4.6,23,Maxell,
186286485,"Ủng Bọc Giày Đi Mưa Cổ Cao Trong Suốt Có Dây Khóa Kéo Chống Bẩn, Chống Thấm",59000,59000,0,4.6,7,OEM,
176251088,Hộp Đựng Thực Phẩm Chữ Nhật Nhiều Cỡ Có Nắp Sản Xuất Theo Tiêu Chuẩn Nhật Bản Inochi ( Tặng kèm khăn lau đa năng pakasa ) - Hàng Chính Hãng ( Giao màu ngẫu nhiên),39000,78000,39000,5.0,4,Inochi,
144549662,"Hạt Giống Cà Pháo Trắng Cao Sản, Dễ Trồng, Siêu Trái - Hạt giống Rạng Đông",11800,11800,0,5.0,1,Hạt giống Rạng Đông,
144521010,"Hạt Giống Ớt Hiểm Sai Trái, Siêu Cay, Trồng Quanh Năm - Hạt giống Rạng Đông",11000,11000,0,5.0,1,Hạt giống Rạng Đông,
134863256,Đầu Chuyển 3 Chấu Thành 2 Chấu Để Sử Dụng Các Loại Ổ Cắm Thông Dụng Ở Việt Nam - Chính Hãng ,25000,50000,25000,4.5,15,PaKaSa,
129722011,Bật Lửa Mồi Lửa Bếp Gas Bếp Cồn An Toàn (Màu Sắc Ngẫu Nhiên) - Hàng Loại 1,29000,29000,0,0.0,0,OEM,
117195930,Pin Maxell Super Đỏ - Hộp 40 Viên Pin Tiểu AA (2A) 1.5V,106900,106900,0,5.0,121,Maxell,
115013188,Giá để giày thông minh Sanada,42000,42000,0,5.0,1,SANADA,
108856769,Hạt giống Cải bẹ Trắng VTS160,11440,11440,0,1.0,1,Sen Vàng Seeds,
74783850,"Lọ xay tiêu DandiHome inox 304, thủy tinh Borosilicat cao cấp trong suốt",115000,115000,0,4.8,122,DandiHome,
67812945,Kệ đỡ màn hình máy tính lắp ghép cải thiện tầm nhìn MS 07 ( 2 mẫu  tùy chọn ),38000,56000,18000,4.5,12,OEM,
53651774,"CỌ LƯNG SILICON, DÂY CỌ LƯNG SILICON - Xanh lá",56000,56000,0,5.0,1,OEM,
46289932,Chảo chống dính Rainy sâu lòng từ 22cm đến 44cm,133000,133000,0,5.0,5,Rainy,
45300792,"Đồng hồ báo thức điện tử để bàn màn hình đa chức năng thời gian, lịch, báo thức, nhiệt độ DH89",109000,125000,16000,4.3,26,OEM,
35919877,"Combo 10 bóng led EDISON ST64 tiết kiệm năng lượng dùng cho trang trí phòng khách, phòng ngủ, quán cafe...",255000,255000,0,5.0,1,Goldseee,
31541799,Đèn diệt muỗi và các loại côn trùng CON DƠI model CN03,620000,620000,0,4.5,192,CON DƠI,
26350629,Ron Dán Chân Cửa Legaxi Keo Đỏ Cải Tiến Ngăn Bụi và Côn Trùng 25 35 45 60 110mm ,53000,53000,0,4.5,808,Legaxi,
11341623,Hộp 40 viên pin 2A Maxell,103100,103100,0,4.8,325,Maxell,
